77777777777777777
90000000000000008
90122010301220108
90224203032252208
92241430003515228
92444442325555528
92141412321515128
92244420302555228
90224442325555208
90122420302522108
90002242325220008
90101222322210108
90000022322000008
90101010001010108
66666666666666666